It's the test of 9*9 maze,begin at point(3,3),end at point(5,5)!!!!
Maze#load:
111111111
100000001
100000001
100000001
100000001
100000001
100000001
100000001
111111111

Maze#redesign:
111111111
111000111
101011011
110001111
100000001
100000011
111101111
111001101
111111111

Maze#solve:
true

Maze#trace:
[3,3]->[2,3]->[2,4]->[1,4]->[1,5]->[2,5]->[3,5]->[4,5]->[5,5]
Maze#trace:This is one of the ways to go!


It's the test of 9*9 maze,begin at point(3,3),end at point(5,5)!!!!
Maze#load:
111111111
100000001
100000001
100000001
100000001
100000001
100000001
100000001
111111111

Maze#redesign:
111111111
110011001
101110001
100001111
110001011
111011001
110111001
100111101
111111111

Maze#solve:
false

Maze#trace:No way out!


It's the test of 9*9 maze,begin at point(3,3),end at point(5,5)!!!!
Maze#load:
111111111
100000001
100000001
100000001
100000001
100000001
100000001
100000001
111111111

Maze#redesign:
111111111
100110101
110100011
111101101
110000101
111100011
110001011
100111011
111111111

Maze#solve:
false

Maze#trace:No way out!


It's the test of 9*9 maze,begin at point(3,3),end at point(5,5)!!!!
Maze#load:
111111111
100000001
100000001
100000001
100000001
100000001
100000001
100000001
111111111

Maze#redesign:
111111111
101100011
111011011
110111011
111001011
110001011
110111101
101011001
111111111

Maze#solve:
false

Maze#trace:No way out!


It's the test of 9*9 maze,begin at point(3,3),end at point(5,5)!!!!
Maze#load:
111111111
100000001
100000001
100000001
100000001
100000001
100000001
100000001
111111111

Maze#redesign:
111111111
100110111
101001101
100001011
100011001
110101011
100011001
111100111
111111111

Maze#solve:
false

Maze#trace:No way out!


It's the test of 10*10 maze,begin at point(5,4),end at point(6,7)!!!!
Maze#load:
1111111111
1000000001
1000000001
1000000001
1000000001
1000000001
1000000001
1000000001
1000000001
1111111111

Maze#redesign:
1111111111
1110100001
1000110101
1100111111
1010011001
1101001011
1001011001
1011101101
1110010011
1111111111

Maze#solve:
false

Maze#trace:No way out!


It's the test of 10*10 maze,begin at point(5,4),end at point(6,7)!!!!
Maze#load:
1111111111
1000000001
1000000001
1000000001
1000000001
1000000001
1000000001
1000000001
1000000001
1111111111

Maze#redesign:
1111111111
1011000011
1000011001
1100001111
1101111101
1011101101
1000111101
1100111111
1011001001
1111111111

Maze#solve:
false

Maze#trace:No way out!


It's the test of 10*10 maze,begin at point(5,4),end at point(6,7)!!!!
Maze#load:
1111111111
1000000001
1000000001
1000000001
1000000001
1000000001
1000000001
1000000001
1000000001
1111111111

Maze#redesign:
1111111111
1101110011
1010110001
1100011011
1111011101
1001101001
1101111011
1001100111
1101001101
1111111111

Maze#solve:
false

Maze#trace:No way out!


It's the test of 10*10 maze,begin at point(5,4),end at point(6,7)!!!!
Maze#load:
1111111111
1000000001
1000000001
1000000001
1000000001
1000000001
1000000001
1000000001
1000000001
1111111111

Maze#redesign:
1111111111
1000101001
1010110011
1111000111
1101010001
1111111111
1001010011
1110100111
1011011001
1111111111

Maze#solve:
false

Maze#trace:No way out!


It's the test of 10*10 maze,begin at point(5,4),end at point(6,7)!!!!
Maze#load:
1111111111
1000000001
1000000001
1000000001
1000000001
1000000001
1000000001
1000000001
1000000001
1111111111

Maze#redesign:
1111111111
1001100111
1110010001
1111111111
1111010011
1101011111
1101000011
1011001101
1100110001
1111111111

Maze#solve:
false

Maze#trace:No way out!


