It's the test of 9*9 maze,begin at point(3,3),end at point(5,5)!!!!
Maze#load:
11111111111
10000000001
10000000001
10000000001
10000000001
10000000001
10000000001
10000000001
10000000001
10000000001
11111111111

Maze#redesign:
11111111111
10011011011
10111001111
10000111001
11000011111
10001000111
10101000101
10000010001
11111110001
11000011101
11111111111

Maze#solve:
true

Maze#trace:
[3, 3]->[2, 3]->[1, 3]->[1, 4]->[0, 4]->[0, 5]->[0, 6]->[1, 6]->[2, 6]->[3, 6]->[4, 6]->[4, 5]->[5, 5]Maze#trace:This is one of the ways to go!


It's the test of 9*9 maze,begin at point(3,3),end at point(5,5)!!!!
Maze#load:
11111111111
10000000001
10000000001
10000000001
10000000001
10000000001
10000000001
10000000001
10000000001
10000000001
11111111111

Maze#redesign:
11111111111
11100110111
11000011111
11111100001
10101111011
11010000101
11100110001
10110110101
10010110001
10000101001
11111111111

Maze#solve:
false

Maze#trace:No way out!


It's the test of 9*9 maze,begin at point(3,3),end at point(5,5)!!!!
Maze#load:
11111111111
10000000001
10000000001
10000000001
10000000001
10000000001
10000000001
10000000001
10000000001
10000000001
11111111111

Maze#redesign:
11111111111
10101110001
11110111101
11000010101
10000110001
11001110101
10011100101
10110000101
10111111111
11110100111
11111111111

Maze#solve:
false

Maze#trace:No way out!


It's the test of 9*9 maze,begin at point(3,3),end at point(5,5)!!!!
Maze#load:
11111111111
10000000001
10000000001
10000000001
10000000001
10000000001
10000000001
10000000001
10000000001
10000000001
11111111111

Maze#redesign:
11111111111
11011001101
11000011111
10000001001
10011010001
11111110101
11110010111
10011011101
11000100001
11001001011
11111111111

Maze#solve:
false

Maze#trace:No way out!


It's the test of 9*9 maze,begin at point(3,3),end at point(5,5)!!!!
Maze#load:
11111111111
10000000001
10000000001
10000000001
10000000001
10000000001
10000000001
10000000001
10000000001
10000000001
11111111111

Maze#redesign:
11111111111
10111011011
10100101011
10000110111
10010110101
11110011101
11010111011
11110101101
10010100101
10111101001
11111111111

Maze#solve:
false

Maze#trace:No way out!


It's the test of 10*10 maze,begin at point(5,4),end at point(6,7)!!!!
Maze#load:
111111111111
100000000001
100000000001
100000000001
100000000001
100000000001
100000000001
100000000001
100000000001
100000000001
100000000001
111111111111

Maze#redesign:
111111111111
101100011001
100000101001
100110001011
101111101011
111010111011
111100100101
100101111101
111100110001
100110011111
100100010001
111111111111

Maze#solve:
false

Maze#trace:No way out!


It's the test of 10*10 maze,begin at point(5,4),end at point(6,7)!!!!
Maze#load:
111111111111
100000000001
100000000001
100000000001
100000000001
100000000001
100000000001
100000000001
100000000001
100000000001
100000000001
111111111111

Maze#redesign:
111111111111
111111011011
100000100011
101110010101
110100011101
100010110111
110111001101
100111111001
111110110101
110010100001
100000010011
111111111111

Maze#solve:
false

Maze#trace:No way out!


It's the test of 10*10 maze,begin at point(5,4),end at point(6,7)!!!!
Maze#load:
111111111111
100000000001
100000000001
100000000001
100000000001
100000000001
100000000001
100000000001
100000000001
100000000001
100000000001
111111111111

Maze#redesign:
111111111111
111100001101
101001111101
100011101111
100110011111
101111100111
100111010001
100001100001
110000010011
110101001001
101111111001
111111111111

Maze#solve:
false

Maze#trace:No way out!


It's the test of 10*10 maze,begin at point(5,4),end at point(6,7)!!!!
Maze#load:
111111111111
100000000001
100000000001
100000000001
100000000001
100000000001
100000000001
100000000001
100000000001
100000000001
100000000001
111111111111

Maze#redesign:
111111111111
110100101111
111110101011
111100111111
111001101111
100111110001
100001011001
101101111111
101011000011
111010111011
111000101001
111111111111

Maze#solve:
false

Maze#trace:No way out!


It's the test of 10*10 maze,begin at point(5,4),end at point(6,7)!!!!
Maze#load:
111111111111
100000000001
100000000001
100000000001
100000000001
100000000001
100000000001
100000000001
100000000001
100000000001
100000000001
111111111111

Maze#redesign:
111111111111
100010111111
101100011001
101111010001
111001110011
110101110111
101100111111
101000110101
100000100001
100001111101
110001000101
111111111111

Maze#solve:
false

Maze#trace:No way out!


