It's the test of 9*9 maze,begin at point(3,5),end at point(5,5)!!!!
Maze#load:
111111111
100000001
100000001
100000001
100000001
100000001
100000001
100000001
111111111

Maze#redesign:
111111111
111100001
111001101
110100001
100100111
101001101
101011011
110000001
111111111

Maze#trace:
[5,5]<-[4,5]<-[3,5]
Maze#trace:This is one of the ways to go!


It's the test of 9*9 maze,begin at point(3,5),end at point(5,5)!!!!
Maze#load:
111111111
100000001
100000001
100000001
100000001
100000001
100000001
100000001
111111111

Maze#redesign:
111111111
100011101
111100001
111111111
100011001
101010111
100101111
101000111
111111111

Maze#trace:
Maze#trace:No way out!


It's the test of 9*9 maze,begin at point(3,5),end at point(5,5)!!!!
Maze#load:
111111111
100000001
100000001
100000001
100000001
100000001
100000001
100000001
111111111

Maze#redesign:
111111111
110000011
100101001
111011001
111100011
110110101
101001001
100101111
111111111

Maze#trace:
Maze#trace:No way out!


It's the test of 9*9 maze,begin at point(3,5),end at point(5,5)!!!!
Maze#load:
111111111
100000001
100000001
100000001
100000001
100000001
100000001
100000001
111111111

Maze#redesign:
111111111
110001101
100101101
101111011
110011111
110011101
101001111
110011111
111111111

Maze#trace:
Maze#trace:No way out!


It's the test of 9*9 maze,begin at point(3,5),end at point(5,5)!!!!
Maze#load:
111111111
100000001
100000001
100000001
100000001
100000001
100000001
100000001
111111111

Maze#redesign:
111111111
111000011
100001011
111011111
100010011
111100011
101011001
101000011
111111111

Maze#trace:
Maze#trace:No way out!


It's the test of 10*10 maze,begin at point(5,5),end at point(6,7)!!!!
Maze#load:
1111111111
1000000001
1000000001
1000000001
1000000001
1000000001
1000000001
1000000001
1000000001
1111111111

Maze#redesign:
1111111111
1000001001
1111100001
1010010101
1011010111
1010100111
1101110111
1101111011
1000011101
1111111111

Maze#trace:
Maze#trace:No way out!


It's the test of 10*10 maze,begin at point(5,5),end at point(6,7)!!!!
Maze#load:
1111111111
1000000001
1000000001
1000000001
1000000001
1000000001
1000000001
1000000001
1000000001
1111111111

Maze#redesign:
1111111111
1110010011
1010100101
1100111001
1111110101
1100000011
1000110001
1001100111
1001100111
1111111111

Maze#trace:
Maze#trace:No way out!


It's the test of 10*10 maze,begin at point(5,5),end at point(6,7)!!!!
Maze#load:
1111111111
1000000001
1000000001
1000000001
1000000001
1000000001
1000000001
1000000001
1000000001
1111111111

Maze#redesign:
1111111111
1011101111
1010101011
1101111011
1011011011
1011010011
1011000001
1010010101
1101101101
1111111111

Maze#trace:
Maze#trace:No way out!


It's the test of 10*10 maze,begin at point(5,5),end at point(6,7)!!!!
Maze#load:
1111111111
1000000001
1000000001
1000000001
1000000001
1000000001
1000000001
1000000001
1000000001
1111111111

Maze#redesign:
1111111111
1100011011
1101011101
1010110001
1001001101
1100010111
1001100101
1000000011
1111101001
1111111111

Maze#trace:
Maze#trace:No way out!


It's the test of 10*10 maze,begin at point(5,5),end at point(6,7)!!!!
Maze#load:
1111111111
1000000001
1000000001
1000000001
1000000001
1000000001
1000000001
1000000001
1000000001
1111111111

Maze#redesign:
1111111111
1001000101
1100100111
1011111111
1001000111
1011110111
1101010011
1111001011
1101001111
1111111111

Maze#trace:
[6,7]<-[5,7]<-[5,6]<-[5,5]
Maze#trace:This is one of the ways to go!


