It's the test of 9*9 maze,begin at point(3,3),end at point(5,5)!!!!
Maze#load:
111111111
100000001
100000001
100000001
100000001
100000001
100000001
100000001
111111111

Maze#redesign:
111111111
101001111
100111011
101100001
110101111
111010101
101011011
110001111
111111111

Maze#solve:
true

Maze#trace:
[3, 3]->[3, 2]->[4, 2]->[5, 2]Maze#trace:This is one of the ways to go!


It's the test of 9*9 maze,begin at point(3,3),end at point(5,5)!!!!
Maze#load:
111111111
100000001
100000001
100000001
100000001
100000001
100000001
100000001
111111111

Maze#redesign:
111111111
110010101
110110101
111110011
100001101
110000011
101001111
110011001
111111111

Maze#solve:
false

Maze#trace:No way out!


It's the test of 9*9 maze,begin at point(3,3),end at point(5,5)!!!!
Maze#load:
111111111
100000001
100000001
100000001
100000001
100000001
100000001
100000001
111111111

Maze#redesign:
111111111
100101001
100100101
111111101
101100001
111101111
101011011
110100001
111111111

Maze#solve:
true

Maze#trace:
[3, 3]->[4, 3]->[5, 3]Maze#trace:This is one of the ways to go!


It's the test of 9*9 maze,begin at point(3,3),end at point(5,5)!!!!
Maze#load:
111111111
100000001
100000001
100000001
100000001
100000001
100000001
100000001
111111111

Maze#redesign:
111111111
100101101
111010101
100111111
100110101
100010011
111000101
110011111
111111111

Maze#solve:
false

Maze#trace:No way out!


It's the test of 9*9 maze,begin at point(3,3),end at point(5,5)!!!!
Maze#load:
111111111
100000001
100000001
100000001
100000001
100000001
100000001
100000001
111111111

Maze#redesign:
111111111
101110001
110000011
110001111
110001111
101010111
100100011
100000011
111111111

Maze#solve:
true

Maze#trace:
[3, 3]->[2, 3]->[1, 3]->[1, 2]->[2, 2]->[3, 2]->[3, 1]->[4, 1]->[5, 1]Maze#trace:This is one of the ways to go!


It's the test of 10*10 maze,begin at point(5,4),end at point(6,7)!!!!
Maze#load:
1111111111
1000000001
1000000001
1000000001
1000000001
1000000001
1000000001
1000000001
1000000001
1111111111

Maze#redesign:
1111111111
1101100001
1011101001
1010100011
1010001111
1100010111
1010101001
1001001011
1100011101
1111111111

Maze#solve:
false

Maze#trace:No way out!


It's the test of 10*10 maze,begin at point(5,4),end at point(6,7)!!!!
Maze#load:
1111111111
1000000001
1000000001
1000000001
1000000001
1000000001
1000000001
1000000001
1000000001
1111111111

Maze#redesign:
1111111111
1000110101
1110010111
1010010111
1110100101
1101101011
1010011001
1101001001
1010000101
1111111111

Maze#solve:
false

Maze#trace:No way out!


It's the test of 10*10 maze,begin at point(5,4),end at point(6,7)!!!!
Maze#load:
1111111111
1000000001
1000000001
1000000001
1000000001
1000000001
1000000001
1000000001
1000000001
1111111111

Maze#redesign:
1111111111
1011111001
1000010001
1000111011
1100101111
1111011101
1100010101
1001110011
1100111111
1111111111

Maze#solve:
false

Maze#trace:No way out!


It's the test of 10*10 maze,begin at point(5,4),end at point(6,7)!!!!
Maze#load:
1111111111
1000000001
1000000001
1000000001
1000000001
1000000001
1000000001
1000000001
1000000001
1111111111

Maze#redesign:
1111111111
1100001011
1111000101
1100101111
1000000111
1010011001
1010011101
1110000111
1100001111
1111111111

Maze#solve:
false

Maze#trace:No way out!


It's the test of 10*10 maze,begin at point(5,4),end at point(6,7)!!!!
Maze#load:
1111111111
1000000001
1000000001
1000000001
1000000001
1000000001
1000000001
1000000001
1000000001
1111111111

Maze#redesign:
1111111111
1101001111
1101101011
1011011011
1100000001
1011100111
1001011101
1011000011
1010111011
1111111111

Maze#solve:
true

Maze#trace:
[5, 4]->[4, 4]->[4, 3]->[5, 3]->[6, 3]Maze#trace:This is one of the ways to go!


