It's the test of 9*9 maze,begin at point(3,5),end at point(5,5)!!!!
Maze#load:
111111111
100000001
100000001
100000001
100000001
100000001
100000001
100000001
111111111

Maze#redesign:
111111111
101010001
101001001
111100011
110100111
111001101
101110001
110011011
111111111

Maze#trace:
[5,5]<-[4,5]<-[3,5]
Maze#trace:This is one of the ways to go!


It's the test of 9*9 maze,begin at point(3,5),end at point(5,5)!!!!
Maze#load:
111111111
100000001
100000001
100000001
100000001
100000001
100000001
100000001
111111111

Maze#redesign:
111111111
111001101
101010111
100111001
110010101
100100101
101011001
101010111
111111111

Maze#trace:
Maze#trace:No way out!


It's the test of 9*9 maze,begin at point(3,5),end at point(5,5)!!!!
Maze#load:
111111111
100000001
100000001
100000001
100000001
100000001
100000001
100000001
111111111

Maze#redesign:
111111111
100100111
111000011
110000101
110111111
100000001
111010011
101100001
111111111

Maze#trace:
Maze#trace:No way out!


It's the test of 9*9 maze,begin at point(3,5),end at point(5,5)!!!!
Maze#load:
111111111
100000001
100000001
100000001
100000001
100000001
100000001
100000001
111111111

Maze#redesign:
111111111
100001001
110011111
100000101
100000001
101101001
111001101
110001101
111111111

Maze#trace:
Maze#trace:No way out!


It's the test of 9*9 maze,begin at point(3,5),end at point(5,5)!!!!
Maze#load:
111111111
100000001
100000001
100000001
100000001
100000001
100000001
100000001
111111111

Maze#redesign:
111111111
110110011
100001011
111010111
111101001
111111101
111001101
110001101
111111111

Maze#trace:
Maze#trace:No way out!


It's the test of 10*10 maze,begin at point(5,5),end at point(6,7)!!!!
Maze#load:
1111111111
1000000001
1000000001
1000000001
1000000001
1000000001
1000000001
1000000001
1000000001
1111111111

Maze#redesign:
1111111111
1010100101
1000100001
1011001111
1001110111
1000001011
1111100111
1001111111
1011101001
1111111111

Maze#trace:
Maze#trace:No way out!


It's the test of 10*10 maze,begin at point(5,5),end at point(6,7)!!!!
Maze#load:
1111111111
1000000001
1000000001
1000000001
1000000001
1000000001
1000000001
1000000001
1000000001
1111111111

Maze#redesign:
1111111111
1011011001
1110000111
1000110101
1110101111
1011001101
1110010011
1110000101
1111000011
1111111111

Maze#trace:
Maze#trace:No way out!


It's the test of 10*10 maze,begin at point(5,5),end at point(6,7)!!!!
Maze#load:
1111111111
1000000001
1000000001
1000000001
1000000001
1000000001
1000000001
1000000001
1000000001
1111111111

Maze#redesign:
1111111111
1000011011
1011001011
1101100101
1100001001
1110011001
1100101011
1101100011
1110100011
1111111111

Maze#trace:
Maze#trace:No way out!


It's the test of 10*10 maze,begin at point(5,5),end at point(6,7)!!!!
Maze#load:
1111111111
1000000001
1000000001
1000000001
1000000001
1000000001
1000000001
1000000001
1000000001
1111111111

Maze#redesign:
1111111111
1010010001
1110101101
1100011001
1011011111
1111100001
1101111101
1001111111
1100010001
1111111111

Maze#trace:
Maze#trace:No way out!


It's the test of 10*10 maze,begin at point(5,5),end at point(6,7)!!!!
Maze#load:
1111111111
1000000001
1000000001
1000000001
1000000001
1000000001
1000000001
1000000001
1000000001
1111111111

Maze#redesign:
1111111111
1010001101
1000001011
1000001101
1010110101
1010010011
1000100011
1101010101
1010100101
1111111111

Maze#trace:
Maze#trace:No way out!


