It's the test of 9*9 maze,begin at point(4,4),end at point(6,6)!!!!
Maze#load:
111111111
100000001
100000001
100000001
100000001
100000001
100000001
100000001
111111111

Maze#redesign:
111111111
111011101
100010111
110000111
100001001
101101001
111100001
110001101
111111111

Maze#solve:
true

Maze#trace:
[4,4]->[4,5]->[4,6]->[5,6]->[6,6]
Maze#trace:This is one of the ways to go!


It's the test of 9*9 maze,begin at point(4,4),end at point(6,6)!!!!
Maze#load:
111111111
100000001
100000001
100000001
100000001
100000001
100000001
100000001
111111111

Maze#redesign:
111111111
101111101
101100011
110011011
111000111
111011001
111111111
111101001
111111111

Maze#solve:
false

Maze#trace:No way out!


It's the test of 9*9 maze,begin at point(4,4),end at point(6,6)!!!!
Maze#load:
111111111
100000001
100000001
100000001
100000001
100000001
100000001
100000001
111111111

Maze#redesign:
111111111
111000001
110100101
100100001
110110111
101101111
111010111
110000011
111111111

Maze#solve:
false

Maze#trace:No way out!


It's the test of 9*9 maze,begin at point(4,4),end at point(6,6)!!!!
Maze#load:
111111111
100000001
100000001
100000001
100000001
100000001
100000001
100000001
111111111

Maze#redesign:
111111111
101110111
110010111
101110101
110111111
111010101
101000111
111110111
111111111

Maze#solve:
false

Maze#trace:No way out!


It's the test of 9*9 maze,begin at point(4,4),end at point(6,6)!!!!
Maze#load:
111111111
100000001
100000001
100000001
100000001
100000001
100000001
100000001
111111111

Maze#redesign:
111111111
101110001
111101001
101111111
110111101
111000111
100001101
111101101
111111111

Maze#solve:
false

Maze#trace:No way out!


It's the test of 10*10 maze,begin at point(6,5),end at point(7,8)!!!!
Maze#load:
1111111111
1000000001
1000000001
1000000001
1000000001
1000000001
1000000001
1000000001
1000000001
1111111111

Maze#redesign:
1111111111
1100011101
1000000001
1001110101
1001000011
1011110101
1101100001
1101011101
1101100001
1111111111

Maze#solve:
true

Maze#trace:
[6,5]->[6,6]->[7,6]
Maze#trace:This is one of the ways to go!


It's the test of 10*10 maze,begin at point(6,5),end at point(7,8)!!!!
Maze#load:
1111111111
1000000001
1000000001
1000000001
1000000001
1000000001
1000000001
1000000001
1000000001
1111111111

Maze#redesign:
1111111111
1000010001
1000001001
1111110111
1010100001
1110000011
1011111101
1010110101
1101100111
1111111111

Maze#solve:
false

Maze#trace:No way out!


It's the test of 10*10 maze,begin at point(6,5),end at point(7,8)!!!!
Maze#load:
1111111111
1000000001
1000000001
1000000001
1000000001
1000000001
1000000001
1000000001
1000000001
1111111111

Maze#redesign:
1111111111
1011101111
1001111101
1001010111
1110001001
1011011111
1010101001
1101010001
1110001011
1111111111

Maze#solve:
false

Maze#trace:No way out!


It's the test of 10*10 maze,begin at point(6,5),end at point(7,8)!!!!
Maze#load:
1111111111
1000000001
1000000001
1000000001
1000000001
1000000001
1000000001
1000000001
1000000001
1111111111

Maze#redesign:
1111111111
1000101001
1111000111
1011001111
1011001101
1000010111
1100111111
1011000101
1000110111
1111111111

Maze#solve:
false

Maze#trace:No way out!


It's the test of 10*10 maze,begin at point(6,5),end at point(7,8)!!!!
Maze#load:
1111111111
1000000001
1000000001
1000000001
1000000001
1000000001
1000000001
1000000001
1000000001
1111111111

Maze#redesign:
1111111111
1101000111
1110011001
1111110111
1100101101
1100110001
1000010111
1111110101
1011011111
1111111111

Maze#solve:
false

Maze#trace:No way out!


